ona	oną	ano	ina	oba	on	na	sona
▁spis	pis
fi	di	fin	fit	fik	fil
łek	lek	nek	sek	tek
▁meta	met
lon	lin	on
▁ważny	wany
wist	west
▁otrzymał	trzymał
zania	wania
pyt	typ	pt	pat	pot
ląd	lad	ład	lud
ov	ob	oz	on	or	os	op	ot	ok	om
trzymać	trzymał
▁bal	bla	ba	al
AM	AN
mont	mon	ont
fic	fi	fin	nic	fit	tic	fik
▁prowadzenia	prowadzeni
▁niez	nie	niem	niej
▁też	te	ten	ter	tek
ios	is	os	ros
▁kol	kul	lok	ko	kl
ros	rus	rod	ro	os
danie	anie
ts	st	ta	as	is	to	os	te
nym	ny	onym	nem
▁kos	ko	ks	os
AT	TA	AR
▁cha	ha	ca	chan	ucha
ór	or	ur	gór	bór	ar	er	ów
▁roz	róż	ro	rz	oz	rodz	raz	ryz	ros
letni	leni
de	se	fe	dr	den	der
kowej	owej
anii	anie
święt	świat
gal	fal	hal	al
ając	dając	ując
tra	tar	art	ta	tera	trwa
▁stał	stal
▁tył	ty	tyn	typ
▁była	był
▁tron	ton	stron	tion
BA	NA
ół	ul	pół	ił	ów
▁wież	wierz	wie
▁przy	prze	trzy
▁miecz	mierz
łu	lu	ług
▁pracę	prac
onego	owego
scy	cy
gl	gł	hl	gal	gli	gul	al	il	go
▁spraw	praw
▁myśli	myśl
tyczne	tycznej	tyczna	tyczny	tyczną
styki	styk	tyki
▁ba	BA	va	na	oba	ban
nica	nic	nice
▁października	październik
pol	pół	pul	po	pl
kol	kul	lok	ko	kl
tk	tka	tak	tek	tyk	ta	to	ok	te
▁tyle	tle
▁ciągu	ciąg
gna	gan	ang	na
▁osi	os	si	nosi
▁znacznie	znaczeni
ston	sto	son	ton	stron	stan
czyk	czy	czak	czek	czyn
▁kończy	kończ	kończył	kończyć
nd	and	ind	end
tel	tle	tek	te	el
tan	ran	ta	an	stan
ada	ad	da	pada
▁płac	łac	płaci
sar	ras	dar	ar	star
▁one	on	ne	ona	oni	ono
▁układ	kład
▁mal	ma	al
enie	nie
tur	tor	rut	tu	ur	tury
▁ryb	bry	rab	ryz
▁XI	II
▁wieś	wie	wieść
ra	ar	ta	era	raz	ran
sse	ss	se
pół	pol	pul
▁dzieli	dziel	dzielił
▁mi	im	ni	mu	ami
▁je	ej	he
wał	wal	ław	wa
ny	by	my	nt	nu	any	iny
ków	ów	nów	rów	ców
czę	cze	cz	cę	cza	czo	czy
szko	szk
cznych	tycznych
▁mm	ma	mi
bie	nie	bi	be	ie
nder	ner	der
mog	mon	mor	moc
dro	ord	dr	do	ro	droż	rod
▁trwał	trwa
▁głośn	głośni
▁mając	dając
li	il	ki	lu	lin
dło	do
▁okręt	kręt
jaw	ja
▁różn	róż	różni
zić	zie	zin
vi	ci	bi	vin	va	ii	ni
bin	vin	bon	bi	in
klas	las
▁nowej	owej
▁przed	prze
▁para	par
gr	fr	hr	gra	gar	gro
zna	za	na
dził	dział	dziw	dzielił
▁rok	kor	rol	ro	ok
▁ład	lad	ląd	dał	ad	kład
owska	owską	owski
lina	lin	ina
łuż	dłuż
▁tor	tur	rot	to	or	stor
▁obaw	oba
owcy	owy	owca	owce
ari	ar	arni
▁dar	dra	rad	far	dat	da	dr	ar
▁siln	sil
łączony	łączono
mon	min	on
▁temu	emu
dni	ind	di	ni
jon	ją	on
czną	czą
bi	vi	ni	bu	bo	bin
łoż	łuż
izm	im	izmu	iem
gen	gę	hen	en	gan	gin	gon
▁norm	nor
iel	ie	il	el	ciel	cel
▁wraz	raz
mel	el
▁jak	ja	rak
roni	robi	oni
▁na	an	ba	ma	ana	ina	ona	zna	nar
lę	len	le	la
por	pro	rop	pot	po	or
ost	ust	os	ot	st
wiąz	wiz
łem	em	łam	iem	nem	rem
yl	ul	al	il	el	pl	kl
bat	bar	ba	at
yzmu	izmu
trz	rz	trze	trzy	tra	tri	try
raż	raz	aż	ran	waż
gląd	ląd
ad	da	as	and	rad	wad	sad	pad
▁dawn	daw	dan
nie	ni	ne	ie	anie	nice
ff	fa	fi	fe	fr
czer	cze	cer	zer	czar	czes	szer	czep	czek
▁widzi	wodzi	więzi
▁su	us	du	si	szu
ień	ie	eń	iem
owi	owo	wi	owie
hr	gr	he	her	ha	ar	hi	ho	or	er
owiec	owie	świec
pon	po	on	pion
or	ur	ro	ot	nor	por	tor
om	im	on	com
ując	ujące	ujący
tak	tka	rak	tal	ta
ości	ość	ością
set	est	ser	se	st	et
niesienie	niesienia
at	ta	st	ar	ant	art	rat	pat
czep	cze
ford	for	ord
ér	ar	or	er	kr	dr	ur	gr	br	hr	fr
▁mierze	mierz
gród	ród	grad
▁prof	pro
szon	żon	son	zon	szyn
list	lit
wie	wi	we	ie	owie
▁eks	es	ks	sek
▁udał	dał
▁sum	mus
ującym	ujący
▁lot	łot	lit	lor	ot
ności	ości
gul	gu	ul
uje	je
ci	vi	co	cie
padł	pad
▁sa	as	da	ss	osa	sza	san
▁po	op	pi	pp	pon	por	pro
ia	is	ina	ita
▁działał	dział
▁mocn	moc	mon
icy	cy	nicy	ice	iny
▁guz	gu	gul
▁czer	cze	cer	zer	czar	czes	szer	czep	czek
▁pyta	pyt
▁sprzed	przed
id	di	ud	od	is	ind	wid
ryz	rz
har	gar	ha	hr	ar	hard
iej	ie	ej	niej	iem
AN	NA	AM
dom	don	do	om
zd	dz	za	ad	id	od	ze
▁komp	kom	kop
nicz	nic	nica	nice	nicy
des	de	es
ther	ter	her
▁ruchu	ruch
czenie	szenie
bit	nit	bot	bi	it
lat	tal	lar	la	at
czewski	szewski
▁przez	prze	przed
zono	zon	ono
rośl	rol
pust	ust
▁liczn	licz
▁ster	str	ser	ter
in	ni	un	on	im	ina	zin	win	iny
cent	cen	ent	centr
la	al	ka	lar	las	lat
▁ochrony	ochron
olnego	onego
ks	ka	as
▁utwór	twór
gres	res
lus	lud	lu	us	las	les
▁różnic	różni
se	es	de	sen	ser	set
ly	lu	ley	la	li	le	ny	wy	cy
duk	du
giel	gier	ciel
▁lub	bul	lu	ub
pat	par	pa	pt	at	part
▁strony	stron
▁skał	ska
▁klub	lub
▁tych	tycz
▁bez	be	ez
ami	mi
łot	lot	ot
cem	cę	cen	ce	em	iem	com	nem	cer
▁dia	di	da
▁kre	ker	kr	re
▁ją	jon	ja	je	cą
ban	van	ba	an
ury	ur	tury
▁słab	sław
prowadził	prowadzić
mysł	myśl
▁dwór	twór
any	ant	anu	an	ny	wany
kami	ami
ch	Ch	ach	ca
▁typ	pyt	ty	top	tyn
▁mln	man	min	mon	men
▁nowa	owa
za	zna	cza	sza
▁cm	com	ca	ci	im	co
▁kręg	kręt
kowi	kwi	owi	kowa
ent	en	et	nt	went	cent
ten	tę	ren	te	en
log	ług	lig	logi
ili	il	ii	li
ław	wał	sław	łow
wane	wan	wanie
▁mur	mor	mir	mu	ur
owego	onego
biał	bił	brał
▁nowych	owych
kowe	owe	kowa
ją	jon	ja	je	cą
ru	ro	ur	tu	rus	rut
▁rad	dar	ras	ad
▁dwa	daw	da	wa	wad	owa
bór	bor	bur	rób	br	bar	ber
pal	pa	pl	al
▁rock	rok
alne	ale
ański	iński
bert	ber	bet
owym	owy	owymi	onym
▁plac	plan	prac
rat	art	tar	at
▁nosił	nosi
dano	dan	ano
▁grupę	grup
olog	log
ający	ujący
▁VI	II
ewska	owska
wit	wi	it	wist
▁hrabi	rabi
▁południe	południ
▁wiek	wie
tle	tel	te	le	ale
god	go	od	gon	rod
cyt	cy	ryt	pyt
rzęd	rząd
ha	ja	han	hal
op	OP	up	po	pp	rop	top
stał	stal
▁łączy	łącz	łączyć
re	er	te	ren
▁cech	cach
moc	com	mon
jącego	ującego
hor	ho	hr	or	her	nor
wa	owa	wan	war
▁włos	włok	głos
tka	tak	ta	ka	tyka
sek	se	szek	szk
▁żony	żon
as	ss	ad	ans	ras
dra	dar	dr	da
▁upraw	praw
unek	nek
▁IV	II	IS
now	nów	no
▁dla	dal	ald	da	la	lad	dra
▁tryb	try
jski	ski
owanie	wanie	owaniem	owania
▁de	se	fe	dr	den	der
jąc	ją	ując
ować	owa	owań
▁broni	roni
cze	czę	cz	ce	ze	czes	czep	czek	cza	cie
ob	ub	bo	on	oba
rot	rut	tor	ro	ot
jan	han	kan	ja	an	jon	ran	jaw
▁atak	tak
gg	ag	go	gr
▁dwu	du
▁swe	se	we	owe
tyczny	styczny	tycznym	tyczna	tyczne	tyczną
cy	czy	cyt
bar	rab	var	nar	bat	ba	br	ar
klar	kar	lar	klas
▁trzy	try	trze	przy
ir	ur	or	ie	it
skie	ski
var	car	bar	va	ar	ver	van	nar	war
zachodni	Zachodni
▁nowe	owe
lą	la	ląd	li
czek	cze	czak	czes
▁le	el	ale	ole	len	lew
▁ojca	owca
▁pism	pis
miot	mit
wer	we	er	wers
▁domu	dom
es	se	ens	res
▁dwie	wie	owie
boż	bo	bon
▁rys	rus
pis	pi	ps	is
lep	pel	le
▁pl	pal	pol	ple	pel	pul	pa	al
▁składzie	kładzie
art	rat	tra	ary	ar	at	wart	part
encji	encja
son	don	sob	on	sona
rządzenie	rządzenia
▁no	nu	on	bo	ni	np	ano	ono	nor
der	red	ser	fer	de	dr	er
pisał	pisać
tta	tra	ta	ita	tka
fil	fik	fi	il
▁IX	II	IS
mu	my	nu	mi	emu	mus
▁wokół	okół
▁prowadzi	prowadził	prowadzić	prowadza
wróci	wrócił	wrócić
▁la	al	ka	lar	las	lat
▁dane	dan	danie
prz	rz	prze	przy	pro
mniej	niej
und	ind	un	ud
▁było	był
óg	ag	ów
▁działa	dział
pres	res	gres
fo	do	go	fi	fon	for
dzenie	szenie
▁rozm	rozum
ża	za	aż	że	na	wa	ca	pa
ość	ości
▁stały	stał
pewni	pełni
▁ton	tą	not	tom	to	on	tion
ust	us	ut	st	pust
mit	nit	mir	mi	it	miot	mat
▁kart	kar	art
hy	hu	ha	hi	ho	he
PR	OR
NA	AN	BA
▁sta	st	ta	ista	stan	star	staw	stat
kan	ka	an
▁październiku	październik
▁tworzy	tworzył	tworzyć
wiad	wid	wad
rt	et	rat	art	rot	ret	ryt	rut
▁tr	te	tra	tar	tri	tor	ter	try	str
▁ku	ko	lu	ki	kur	kup
tury	tur	try
▁prawa	praw
▁miejskie	miejski
kach	ach
dor	rod	for	do	dr	or	ord	dar
ciel	dziel	cie	cel
ży	żyt	żył	że	ny
lega	leg
ge	gę	fe	he	gr	gen
nią	ni	nie
szą	sza	czą	szt	szk	szu
▁czeka	czek	czka
▁walk	wal	wali
gon	fon	gin	go	on	agon
▁VIII	III
kup	kop	ku	up
ol	ul	il	pl	ok	ole	rol	sol	pol
an	AN	na	ana	ano	ran	wan
owana	owania
ły	ny	wy	cy
▁kon	jon	kom	ko	on
▁jazdy	jazd
▁sport	port
logi	log
▁mis	mus	mi	is
per	pe	er
my	ny	mu
ciąg	ciąż
ró	ro	rów	ród	rób	róż	re	rz
▁klas	las
prowadzić	prowadził
śni	ni	oni
ar	AR	at	ari	nar	war	car
▁ha	ja	han	hal
róż	rów
czeń	cze	czes	czep	czek
owce	owe	owca	owie
cja	ca	ja	cza
▁pap	pa	pp
dż	dz	da	aż	di	do	de	dr	dy
▁egz	ez	ego
▁des	de	es
gł	ił	go	gr
▁km	kom	ka
leż	le
puścić	puścił
▁opisał	pisał
mas	ma	as
sy	dy	st	syn
kla	kl	ka	la	klar	klas
hol	ho	hl	hal	hel
iny	in	ny
ras	rad	as
szew	szer	szek
siadł	siada
▁leży	leż	ley
ew	we
▁stworzył	tworzył
▁dniu	dni
lok	kol	lik	ok
▁gr	fr	hr	gra	gar	gro
port	por	pot
cal	ca	al
▁używa	żywa
▁ar	AR	at	ari	nar	war	car
▁stop	sto	top
▁An	AN
hen	gen	he	en	han
▁jej	je	ej
▁lu	ul	ku	li
▁utworzył	tworzył
ting	ring	ling
▁geo	ego	gro	go	gen
owany	wany
ujące	ując	ujący
usz	us
owymi	owym
que	qua	qui
stadt	stat
▁spadł	padł	siadł
iz	oz	wiz	izm
▁ran	nar	tan	rab	ram	an
onych	owych
ających	ujących
pan	pa	an
zę	ze	że	czę
▁mod	dom	od
przed	prze
nki	ni	ki	ski
ex	ez
lik	lok	li	plik
ił	il	sił	bił	ii
▁tworzenie	tworzeniu
tycznej	tyczne
rod	ród	ord	ros	ro	od	rodz
pe	pie	pen	per	pel	ple
▁kadr	kar
▁hip	hi
iego	ego
oną	ona	on
▁ja	ją	ha	ka	jaw
min	mon	mi	in	mian
nik	ni	nie
▁fla	fal	fa	la
▁mor	nor	mir	or
▁płyt	pyt	płat	pływ
▁równo	równa
ang	gna	an	ag
▁os	us	is	ps	od	osa
dr	fr	de	dra	dar	der
ąc	cą
kł	kl	ka	ki	ił	ko	kr
▁ogół	okół
we	wę	ew	wie	owe	wen
▁Chi	Ch
▁wcześniejsz	wcześniej
▁kor	kur	kro	rok	lor	ko	kr	or
eld	el	del	ald	end
pro	por	po	ro
kt	kr	ka	at
si	is	di
ti	it	tu	to	tri	tic
▁pewn	pen	pewni
▁zbudowany	budowany
ma	na
be	ne	br	ben	ber	bet	bel	ble
ców	ów	nów	rów	łów
ans	ana	and	an	as
▁tra	tar	art	ta	tera	trwa
▁pol	pół	pul	po	pl
pi	po	pie
fal	dal	gal	fa	al
nej	nek	ne	ej	niej	ner
sol	dol	sil
się	si
ul	lu	il	pul	kul
owali	wali
▁swym	owym
ński	ski	iński
co	ci	czo	con	com
▁pr	PR	or	pe	pt	par	pro	por	per
nice	nic	nie	ice
owane	owanie
bur	bor	bór	bu	br	ur
▁granic	grani
▁kat	tak	lat	kar	ka	at
▁żonę	żon
▁ci	vi	co	cie
▁mocy	moc
unk	un	und
tworzyć	tworzył
czes	cze	czep	czek
hu	ho	gu	hi
▁budowy	budowa
▁służy	służył
▁dr	fr	de	dra	dar	der
zon	żon	zin	on	zono
▁polskie	polski
br	be	bar	bor	ber	bry	bur	bór
▁oni	ono	on	ni	roni
tro	rot	tor	tri	to	ro	trop
ym	my
pt	ot	pat	pot	pyt
bus	bud	bu	us
▁kin	lin	ki	in
dat	dar	da	at
▁barw	bar
chodził	chodzi
kier	ker
▁XII	II	III
▁krzyż	krzyw
aty	ary	atu	at	ty
▁listy	list	isty
▁nowym	owym
▁not	ont	ton	bot	nit	nor	no	nt	ot
▁tę	ten	te
▁wszedł	szedł
▁polska	polski
owice	owiec	owie	owce
tri	tra	ari
ssa	ss	osa	sza
dz	da	di	do	oz
▁czym	czyn	czy
gi	fi	hi	gu	go	gin
owski	nowski	owskim	owska
tin	nit	ton	in	tion	tan	ten
kop	kup	ko	op
▁bas	ba	as
pl	pal	pol	ple	pel	pul	pa	al
▁Cho	Ch
bo	bu	ob	no	bi	bon	bor
ward	war	wad
le	el	ale	ole	len	lew
ben	be	en	ban	bin	bon	ber	ren
unt	ont	un	ut	nt
▁włók	włok
kowskiego	owskiego
▁park	par	ark
▁polską	polski
lant	lat	ant
▁szersz	szerz	szer
▁szczególn	szczególne
▁szyb	szyn
bu	by	bo	ub	nu	bi	bur
▁polsko	polski
lan	kan	la	an
▁roku	rok
ego	go
▁udan	dan
rodz	rod
di	id	si	fi	du	do
nem	men	ne	em	anem	niem
bil	bił	bul	bi	il
▁rodu	rod	rodz
▁kraj	kra	raj
▁baz	ba
▁tej	tek	te	ej	ten
ker	kr	er	kier	kar
je	ej	he
cją	cą	ją	czą
czyn	czy	czyni	szyn
anu	any	ano	an	nu
▁rodzi	rodz	rodził
▁krok	kro	rok
ok	ko	rok
ba	BA	va	na	oba	ban
nę	nem	ne
▁ich	ach	ice
zo	oz	zon	czo
ning	ring	ling
raj	rak
ością	ości
▁zbudowano	budowano
▁regionu	region
▁pal	pa	pl	al
▁możliwy	możliwi
las	lad	la	as
▁gdy	dy
▁las	lad	la	as
lit	lot	li	it	list
▁brak	rak
aż	waż	an	ar
▁ten	tę	ren	te	en
ót	ot	ut	at	it	et	nt	ów	st	pt	ód	ft
szu	sza
dać	da	dan	dar	daw
pęd	pad	pod
▁VII	II	III
▁św	ew
ńskiego	ińskiego
bog	bo
owy	wy	owcy	owym
▁in	ni	un	on	im	ina	zin	win	iny
ód	od	ud	ród	wód	ad	id	ów
oid	od	id	ord	wid
▁kas	las	ka	ks	as
ry	ty	ary	ryz	rys	ryt	try	ryk
gra	gar	gr	gran
lec	cel	le
▁ur	or	ut
▁przede	przed
al	la	ale	wal	cal	pal
ki	li	ku	ko
▁farm	far	form
▁plam	plan
fr	dr	gr	fe	ft	far	for	fer
▁cał	cal	łac	ca
lla	la	bla
▁Cha	Ch
nion	nią	pion	tion
BC	BA
▁skład	kład
ze	że	ez	zie	zer	cze
ską	ska	ski
▁pi	po	pie
▁prze	przed
wo	wi	owo
sburg	burg
▁chwil	cywil
ła	la	ław	łac
stol	sto	sol
ation	tion
ól	ul	al	il	el
eb	be	en
owie	owi	owe	wie	owiec
zan	zna	za	an	zin	zon
ryk	tyk
nios	nosi
▁zmian	mian
▁wojewódzk	województwo
byt	by	bat	bit	bot	bet	ryt	cyt
owań	owa
▁pory	port	por
czą	cza	cz	cą	czo	cze	czy
ają	ją
sp	ps
em	en	iem	nem	rem	sem	dem
sil	sił	sol	si	il
▁ukończył	kończył
▁jedną	jedno
▁sobą	sob
hl	hal	hol	hel	ha	al	hi	il	ho	he	el	hr
bry	br	by
ont	not	on	ot	nt
czki	czka
ozy	oz
ej	je
wrócił	wróci	wrócić
III	II
▁dróg	gród
▁uległ	legł
▁tam	mat	ram	tan	ta
pisać	pisał
zu	szu
rzucił	rzuci
▁stało	stał
▁aby	any	by
▁znaczenia	znaczeni
ero	er	ro
▁od	ód	ud	do	id	os
us	os	is	ud	rus
pla	pal	pl	pa	la	plan
tus	rus	tu	ts	us	ust
ong	on
shi	si	hi	ski
publ	pul
ord	rod	or	od
▁religijne	religijny
zięci	cięci
▁bud	bus	bu	ud
ron	nor	ton	ro	on	roni
jące	ujące
ton	tą	not	tom	to	on	tion
▁kom	ko	om
ild	il	id	ald	ind
puścił	puścić
▁Che	Ch
▁wschodnim	wschodni
▁epi	pi	pie
leg	le	lega	legł
▁ogon	gon	agon
▁spor	por
kar	kra	rak	lar	ka	kr	ar
wol	wo
ub	ob	bu	un
ista	ita
wi	wo	owi	wie	wiz	win
▁dni	ind	di	ni
ier	ie	er	kier	gier	zer	ner	cer	ser	per
▁tj	th	ta	to	te	ej
tyk	ryk	ty	tyka	tyki	styk
stor	sto	str	tor
▁kap	ka
▁zwany	wany
▁mas	ma	as
▁rodzin	rodził
iem	ie	im	em	niem
▁żywo	żywi	żywa
str	st	star	stor	ster	sto	ser
chan	han
▁sejm	sem
ograf	graf	ogram
▁per	pe	er
ries	res
cji	ci
▁the	th	te	he
lip	li
cer	ver	ce	er
MP	OP
woł	łow	wo	wał
▁sens	sen	ens
▁ta	tą	at	ts	ita	tan	tar	tra
▁tlen	tle	ten	len
ian	ina	in	an	mian
nię	niem	nie	ni
żon	zon	on	con
▁str	st	star	stor	ster	sto	ser
jący	ujący
▁zde	ze	de	zie
▁cz	czy	cza	czo	cze	czą	czę
▁niż	ni	nie
sta	st	ta	ista	stan	star	staw	stat
ita	it	ta	ista
▁pas	pad	pa	ps	as
kon	jon	kom	ko	on
kre	ker	kr	re
▁pracy	prac
gier	kier
ych	ach
▁sosn	son
chodzi	chodził	chodzą
ke	je	le	kr	ker
słan	san	sław	stan
rów	ów	nów	ców	ród
kiem	iem
grani	gran
den	sen	dem	de	en	dent	end
▁tworzenia	tworzeniu
lor	rol	kor	lot	or
▁niemiecką	niemiecki
owca	owa	owce	owcy
▁fi	di	fin	fit	fik	fil
trop	top	rop
ko	ku	ok	ki	kor	kro
▁kot	lot	kor	ko	ot
alny	any
gór	gr	gar
▁pra	par	pa	praw	prac
itz	it	ita
▁ras	rad	as
trzy	try	trze	przy
▁płyn	pływ
ńska	ska
hal	gal	ha	hl	al
mor	nor	mir	or
mana	man	ana
▁fan	dan	gan	fa	an
ryt	rut
sona	son	ona
rog	ro	gro
raz	rz
is	IS	si	us	os	id	pis
ofi	fi	oni	owi
pot	top	por	po	pt	ot	port
sk	ks	ska	ski	sek	szk
da	ad	fa	dan	dar	dra	daw
▁nich	nic	nica	nice	nicy
▁twórc	twór
słon	son
▁di	id	si	fi	du	do
par	pat	pa	ar
gro	gr	go	ro
▁państwa	państw
▁klasy	klas
▁tajn	tan
pion	pon	tion
oni	ono	on	ni	roni
kle	kl	le
qua	qui	que
▁kar	kra	rak	lar	ka	kr	ar
▁walki	wali
▁wyp	wy	typ
oba	ona	ob	ba
▁obc	ob	oba
nosząc	noszą
▁kur	kor	ku	kr	ur
▁mistrza	mistrz
▁spa	sp	pa
wic	wi	więc	wie	wiz	win	nic
and	ans	an	ad	land
▁doskonał	doskonal
tąd	tą	ląd
bro	bor	br	bo	ro
▁ds	ss	da	des	as	di	is
▁or	ur	ro	ot	nor	por	tor
lu	ul	ku	li
plik	lik
kom	ko	om
▁fal	dal	gal	fa	al
▁ok	ko	rok
ta	tą	at	ts	ita	tan	tar	tra
▁bo	bu	ob	no	bi	bon	bor
vin	bin	vi	in	van
bol	bul	bil	bo
wodzeni	rodzeni
▁pola	pol
ie	zie	nie	wie	ice	cie	pie	iem
rr	er	re	ar	ro
rza	sza	raz	rz	za
zar	raz	za	ar	czar	zer	nar
ań	an
▁III	II
▁brat	bat	rat
chodzą	chodząc	chodzi
osobowy	osobowe
ring	ling
▁bi	vi	ni	bu	bo	bin
▁znaczn	znacz
van	ban	va	an	vin	var	ran	wan	san
▁ogni	oni
▁stóp	stęp
ji	hi	ki	ja	ii	je	ni
rzuca	rzuci
owską	owska	owski
mal	ma	al
czyni	czyn	czyli
owa	ową	wa	owca	kowa
trzymał	trzymać
bl	bla	bal	bil	ble	bel	bul	ba	al
▁opis	pis
▁prace	prac
▁biegu	bieg	biegł
dy	yd	du	dyn
lig	log	li	ling	gli
cznego	czego
▁legaln	lega
▁Am	AM
ono	oni	on	no	zono
czył	czy	czyn
▁du	dy	do	ud	di
▁and	ans	an	ad	land
enia	anie
ój	bój	ej	ów
tu	ty	to	ut	atu
gar	gra	far	gat	gr	ar
ku	ko	lu	ki	kur	kup
▁stronę	stron
rządzenia	rządzenie
styk	tyk	styki
dal	dał	lad	fal	da	al
gh	go	gr	th	gł	gu	gę
▁zbyt	byt
chodząc	chodzą
kład	ład
rodzeni	wodzeni
cel	vel	ce	el	ciel
nes	ens	sen	ne	es	ner	res
cą	com	con	ca	czą	ci	co	ce	cz
bra	bar	br	ba	brał
noszon	noszą
ers	res	era	er	es	wers	ser	ero
ola	la
sa	as	da	ss	osa	sza	san
nego	ego	onego
▁był	by
▁wsi	wi	si
bój	boj	bór
niec	nice	nie	nic
▁przod	przed
▁budowę	budowa
▁budowla	budowa
kur	kor	ku	kr	ur
▁do	du	od	di	don
czny	czyn	czy
ole	ple	le
rak	ark	kar	tak	raj
rób	bór	rab	rów	ród
sko	ski	ko	skop
ss	as	si
morf	form	mor
met	mer	et	metr	mat
sław	ław
mus	mu	us	mas
wietrz	wierz
not	ont	ton	bot	nit	nor	no	nt	ot
go	gu	ho	ego	gon	gro
act	at	ant	art
el	le	cel	pel	tel	mel	del	bel
one	on	ne	ona	oni	ono
ryn	tyn	ran	ren	ryz	rys	syn
encja	encji
rzył	żył
▁car	var	ca	ar	czar
hi	hu	ho
▁osad	osa	sad
her	he	hr	er
▁gł	ił	go	gr
▁mieścił	mieści
tyl	tyk	ty	tal
▁pło	po
▁wpływ	pływ
śle	le	ale	ole	ple	tle	kle
prze	przed
▁ciąg	ciąż
▁znaczenie	znaczeni
▁opowiada	powiada
dź	dz	da	di	do	de	dr	dy
cko	ck	co	ko	czo
kro	kor	kr	ko	ro
dia	di	da
▁równowag	równoważ
czno	czo
dzie	dziw	zie	dziel	dziej
krywa	grywa
ic	ci	ice	nic	tic
▁pion	pon	tion
▁znak	zna
put	pyt	pot	pt	ut	pust	pat
rob	rób	bor	ro	ob	robi	rab
▁nad	and	dan	na	ad
że	ze
rzut	rut
▁euro	ero
to	tu	ot	ro	ton	tor
▁pół	pol	pul
ena	ens	en	na
▁pełną	pełni
czni	czyni
▁wiedzy	wiedza
atu	at	tu
it	ut	ot	ita	nit
do	du	od	di	don
sie	się	si	se	ie
▁los	sol	os	las
nk	nek	na	ni	no	ok	ne	ck	ny
iony	iny
tyczną	tyczna	tyczne	tyczny
ber	ver	ner	bet	be	br	er
▁stos	sto	stor
ft	fr	fit	fa	at	fi
typ	pyt	ty	top	tyn
▁se	es	de	sen	ser	set
np	no	na	ni
bran	ban	ran
bież	bieg
szcze	szczy
żywi	żywa
kaz	ka	kan
ce	cę	cie	ice	cze	cen	cer
te	tę	et	re	ten	ter
ped	pęd	pe	pad	pod	pen	per	red
gno	gon	go	no	gna	ano	ono	gro
▁polskim	polski
▁bram	ram
ić	ii	ie	in	is
rad	dar	ras	ad
cie	ice	ci	ce	ie
fer	der	fe	fr	er
▁lud	lu	ud	lad
ańskiego	ińskiego
▁grub	grup
▁swej	owej
cjo	co	czo
bieg	biegł
▁iż	aż	ii	ie	in	is
gu	go	hu	gul
▁pre	per	pe	re	prze	pie	pro	ple
▁for	fr	or	form	ford
▁mono	mon	ono
ien	iem	ie	in	en	nie
len	le	en	leni
▁go	gu	ho	ego	gon	gro
agon	gon
yd	dy	ud	ad	id	od
dła	dał	da	ład	dra
dem	sem	den	de	em
owania	wania	owanie	owaniu
▁uzyskał	zyskał
▁tuż	tu	tur	łuż
▁par	pat	pa	ar
▁ser	res	der	set	se	er	szer
▁europejskie	europejski
▁prowadzenie	prowadzeni
▁mówi	mówił
fl	fal	fil	fa	al	fi	il	fe	el
metr	met	mer
zja	za	ja	zna
gle	le	leg	ale
▁art	rat	tra	ary	ar	at	wart	part
red	der	res	re
▁sk	ks	ska	ski	sek	szk
▁cen	cę	ce	en	cent
▁star	stat	str	tar
ka	ja	la	ks	kan
zi	zie	zin	za
fe	de	fr	fer
▁zaś	za
▁et	te	er	ent
wyż	wy	waż
▁swego	owego
ham	han	ha
ciąż	ciąg
kowo	owo	kowa
bul	lub	bil	bu	ul
tek	tel	te
II	III
▁złożył	łożył
án	an	in	on	en	un
zer	ze	er	szer
row	rów	ro	ros	rop	rot
nor	bor	mor	not	no	or
sza	za
gran	gra	gan	ran	grani
▁of	uf	od	oz	on	or
kową	kowa	ową
▁nowego	owego
mar	ram	nar	mat	ma	ar	miar
▁typu	typ
dał	dal	ład	da
osobowe	osobowy
sygn	syn
cje	ce	je	cie	cze	uje
wor	wo	or	war	nor
▁razy	raz
kwi	ki	wi
dziel	dziej
▁blok	lok
▁zachodni	Zachodni
▁olej	ole
bla	bal	ba	la
man	ma	an	mana	mian
▁ostr	str	stor
▁to	tu	ot	ro	ton	tor
▁średnio	średni
stwa	staw	suwa
lin	li	in	lina
▁sal	las	dal	al
▁stanu	stan
sob	son	ob
▁dziś	dziw
▁mieście	mieści
wać	wa	wan	war
▁pt	ot	pat	pot	pyt
cia	ci	ca	cie	cza
▁nocy	nicy
kę	ka	ki	ko	kr	wę
óż	oz	róż	aż	ów	ód
płynęł	płynął
▁pięć	pięt
amp	ami
▁Ba	BA
war	wa	ar	wart
▁dysk	zysk
ón	on	un	an	in	en	ów	ód
▁opuścił	puścił
▁so	os	do	si	sp	son
emu	em	mu
▁Pr	PR
rok	kor	rol	ro	ok
budowano	budowany
roz	róż	ro	rz	oz	rodz	raz	ryz	ros
grob	gro
kowa	owa
kowym	owym
san	dan	an
▁syn	dyn	szyn	sygn	san	son	sen
▁miano	mian
lad	ląd	ład	ald	dal	las	la	ad	land
owni	owi	oni
▁nowo	owo
wiz	wi	wiąz	wie
ag	ang
▁nowy	owy
nicy	nic	nica	nice
res	ser	red	re	es	gres
cen	cę	ce	en	cent
st	ts	at	sto	set	est	szt	str
tom	tą	ton	to	om
miar	mir	mar	mian
rzy	ryz	rz	przy	trzy	ozy
▁pełnił	pełni
stal	stał	tal
tworzył	tworzyć
sem	dem	sen	se	em
daw	wad	da	dow	dan	dar
żywa	żywi
ster	str	ser	ter
▁szef	szer	szew	szek
tyka	tyk	tka
▁tego	ego
lni	lin	li	ni	leni	oni
jących	ujących
▁film	fil
▁kr	kra	kar	kro	kor	ker	kry
▁grupy	grup
czych	szych
ione	one
▁nie	ni	ne	ie	anie	nice
▁on	ON	un	no	in	ob	om	ona	oni	ono
▁wnętrza	wnętrz
stat	star
świec	owiec
▁jaj	ja
ary	art	ar
▁raz	rz
▁amerykańska	amerykański
▁kop	kup	ko	op
▁jest	est	west
▁boj	bój	bo
hard	gard
▁pilot	polit
rzuci	rzucił	rzuca
▁mniej	niej
dziej	dziel
▁sprzeciw	przeciw
sad	ad
▁wrócił	wróci	wrócić
owej	owe
▁stan	san	tan
ony	iny	ont	on	ny	onym
kry	kr
ca	cą	va	cza	car
onym	owym
▁lo	lu	ko	li	lor	lot	lok
▁da	ad	fa	dan	dar	dra	daw
▁fort	for
nia	nią	ina	ni	na	nica
ett	ety	et	ent	est
rę	rem	ren	re	tę
▁chr	hr	car
ujący	ując	ującym	ujące
▁poli	pol
łączono	łączony
▁targ	tar
nowski	owski
zie	ze	ie
sti	sto	st	si	str	ski
▁skok	skop
uf	ud
ski	si	ki
nit	bit	mit	not	ni	nt	it
▁gra	gar	gr	gran
cjan	chan
kl	kol	kle	kul	ka	al	ki	il
▁kra	kar	ark	kr	ka
▁ocen	cen
dan	san	da	an
▁tak	tka	rak	tal	ta
był	by
rzę	rz
▁obr	bor	ob	or	br	oba
ady	ad	dy
robi	roni
er	re	et	era	ero	zer	ner	cer	ser
▁pieśni	pieni
▁pływa	pływ
bel	ble	vel	be	el
ur	or	ut
▁okazał	kazał
ple	pel	ole	pl	pe	le
▁celu	cel
sen	den	sem	se	en
cznym	tycznym
szerz	szer
▁co	ci	czo	con	com
▁kl	kol	kle	kul	ka	al	ki	il
▁ska	ka
▁ślad	lad
▁sek	se	szek	szk
ing	in	ring	ling
win	wi	in
mat	mar	ma	at
he	je	hr	hen	her
pel	ple	lep	pe	pl	el
▁dys	dy	des	dyn	rys
by	ny	bu	bry	byt
let	tel	ley	le	et	tle	lat
▁ni	in	bi	mi	nu	no	oni	nie	nic
rzenie	szenie
jska	ska
pr	PR	or	pe	pt	par	pro	por	per
▁gmin	gin	min
kow	ko	kowa	kor	kop
owe	we	owie	owce	owej	owa	owi	owo
▁moc	com	mon
gur	gór	gu	gr	ur	gar
▁szczególnie	szczególne
owych	onych
KS	AS
▁bar	rab	var	nar	bat	ba	br	ar
stos	sto	stor
rio	ro
ph	pa	pi	po	pe
aniu	anu	anie
ment	men	met	ent	went	cent
ez	ze	rz	ex
▁zm	izm	za	im	om	ze	em
cką	ck	cą	czą
ana	ans	an	na
dow	do	daw	don
▁FC	FI
mier	mir	mer	mierz	miar
▁styl	styk	stal
▁kult	kul
kr	kra	kar	kro	kor	ker	kry
▁linia	lina
hel	he	hl	el
ło	lu	łow	łot
bor	bór	bur	nor	bot	bo	br	or
nic	ni	nica	nice	nicy
▁op	OP	up	po	pp	rop	top
▁test	est	west
pada	pad
bal	bla	ba	al
owskim	owski
izmu	izm
stać	stan	star	staw	stat
nych	onych
no	nu	on	bo	ni	np	ano	ono	nor
▁znalazł	nalazł
▁bu	by	bo	ub	nu	bi	bur
eniem	niem
lek	le
ls	ks	la	las	les	as	li	is
sel	les	del	sek	se	el	sil	sol	sen	ser
▁neo	ne	no	one
▁formy	form
▁mu	my	nu	mi	emu	mus
▁kwiat	świat
▁schron	ochron
lne	len	le	ne	one
ano	anu	ona	an	no
fin	gin	fon	fi	in
ram	mar	ran
▁ros	rus	rod	ro	os
ek	ej	el	nek	sek	tek
tera	ter	tra	era
zor	or	zer	zon	nor	por	tor
▁jedn	jedno
▁wodzą	wodzi
trwa	tra
tycznym	tyczny
wart	war	art
ind	dni	und	in	id
▁pole	pol	ple	ole
▁jego	ego
▁np	no	na	ni
ren	ner	ten	rem	re	en
sion	son	pion	tion
▁bezpieczeństwa	bezpieczeństwo
rz	ez	raz	ryz	ro	oz	re	cz
▁by	ny	bu	bry	byt
▁spo	sp	po	społ
rom	mor	tom	ro	om
lud	lu	ud	lad
wschodni	Wschodni
land	lad	and
▁wśród	śród
▁gry	gr
fa	da	far
lk	kl	lik	lok	lek	la	li	ok
szym	szyn
tiv	tic
▁południa	południ
lub	bul	lu	ub
wany	wan	any
ern	ren	er	en	ner	era	ero
ud	yd	od	ód	du	id	us	uf
▁hist	wist	list
▁sam	mas	san
kowego	owego
eni	eń	en	ni	leni
ed	de	es	end	red
▁dał	dal	ład	da
cka	ck	ca	ka	czka	cza
szka	szk	sza	ska	czka
▁ze	że	ez	zie	zer	cze
▁urodził	rodził
fit	fi	ft	it
▁mag	ma	ag	maga
▁liczb	licz
▁kal	ka	kl	al
cza	czą	cz	ca	za	czar	czak	czka
▁musi	mus
▁ona	oną	ano	ina	oba	on	na	sona
▁mon	min	on
▁re	er	te	ren
▁są	son	si	se
▁Af	AF
ck	ca	ci	co	ok	ce	cz
▁bieg	biegł
▁fil	fik	fi	il
▁noc	con	moc	nic	no	nor
wad	daw	wa	ad
men	nem	en
rg	gr	erg	ag	ro
▁końca	kończ
ist	ust	is	it	st	ista	wist	isty	list
legł	leg	lega
▁hu	ho	gu	hi
ymi	mi	ami
kra	kar	ark	kr	ka
wid	wi	id
na	an	ba	ma	ana	ina	ona	zna	nar
ven	cen	ben	en	van	vin	ver	ren	wen	sen	pen
ów	nów	rów	ców	łów	ew
eń	en
▁obecności	obecność
zyn	czyn	szyn	zin	zon	syn	tyn	dyn
cę	cen	ce	czę	ca	ci	co	cz	wę	cy
▁uni	oni	un	ni
▁sub	sob	bus	ub
ład	lad	ląd	dał	ad	kład
ory	or
▁rządu	rząd
▁ani	ina	ami	anu	ano	an	ni	anie	arni
plan	pan
ast	as	at	st
tal	lat	tak	ta	al	stal
▁dach	ach
nt	ny	ant	nit	not	ont	ent	na
erg	er	era	ero
wój	woj
wierz	wietrz
▁różne	różni
▁aż	waż	an	ar
stwo	sto
▁znaczeniu	znaczeni
rabi	rab	robi
▁oper	per
ser	res	der	set	se	er	szer
▁siły	sił	szły
▁ju	hu	ku
owaniu	owania	owanie
cław	ław	sław
▁von	con	bon	vin	on	van	zon	son	pon	ton
sor	ros	or	stor
▁liczy	licz
▁start	star	stat
ler	ker	le	er	lar	lor	zer	len
onii	oni
zą	zon	za	czą
strze	trze
▁dom	don	do	om
wano	wan	ano
ll	kl	la	al	li	il	le	el	pl
▁ale	al	le
im	mi	om	in	iem	izm
sku	ski	ku
dłuż	łuż
▁stu	sto	atu	st	tu	ust
▁szczyt	szczy
os	us	is	ps	od	osa
▁gen	gę	hen	en	gan	gin	gon
styczny	tyczny
ür	ar	or	er	kr	dr	ur	gr	br	hr	fr
szcz	szczy
dze	dz	de	ze	cze
pod	po	od
ioł	ił
▁be	ne	br	ben	ber	bet	bel	ble
ręb	rab	rób
tem	tę	met	rem	ten	te	em
▁projektu	projekt
▁żoną	żon	oną
dol	sol	do
▁miejsca	miejsc
sztyn	szyn
va	ca	ba	van	var	vi
ant	any	an	at	nt
▁im	mi	om	in	iem	izm
▁możliwe	możliwi
płat	pat
▁ho	hu	go	hi
czej	czek	cze	czes	czep
went	wen	ent
osa	os
ium	im	iem	izm
don	son	fon	dom	do	on
ig	lig
ng	ang	na	ag	ni	no	ne
▁fa	da	far
▁oprócz	prócz
jącym	ującym
skop	kop
zy	ozy	czy
ak	ka	al	ark	rak	tak
ńca	nica	ca
▁niej	nie	mniej	niem
con	cą	com	co	on	cen
▁nową	ową
ug	gu	uf	ług
arz	aż	raz	ar	rz
ste	set	str	st	se	te	ster
▁województwa	województwo
▁kg	ka	ag	ki	ko	kr
▁urządzenia	rządzenia
łów	łow	ów	ław
en	eń	ne	em	ren	wen	cen	ens	sen
wal	wał	wa	al	wali
▁niemieckim	niemiecki
tki	ki	tyki
żan	an	żon	ran	wan	san	pan	tan
▁południu	południ
▁czy	cz	cy	czyn	cza
ające	ujące
stan	san	tan
kazać	kazał
cki	ck	ci	ki	ski
ty	tu	ety	tyn	try	typ	tyk
nu	ny	no	un	bu	mu	ni	anu
▁rzek	szek	czek
szer	ser	zer	szerz	szew	ster	szek
bet	ber	be	et	bert
wanie	anie	owanie
▁RP	OP
▁gwar	gar	war
dyn	syn	dy
kul	kol	ku	kl	ul
▁pro	por	po	ro
▁sąd	sad	ląd
gard	grad	hard	gar
▁fr	dr	gr	fe	ft	far	for	fer
ga	ag	fa	ha	gan	gna	gar	gra
▁spod	pod
niu	ni	nu	nie
burg	bur
▁ślub	lub
car	var	ca	ar	czar
owo	owi	wo	owa
part	par	pat	art
▁ul	lu	il	pul	kul
star	stat	str	tar
▁rąk	rak	rok	ryk
rywa	grywa
▁za	zna	cza	sza
dyk	dy	dyn	ryk
zin	zon	in	zie	win
łóc	łac	łów
od	ód	ud	do	id	os
hn	han	hen	ha	an	hi	in	ho	on	he	en
▁ks	ka	as
for	fr	or	form	ford
arni	ari
technic	technik
▁plan	pan
▁już	łuż
ina	ona	in	na
▁sto	st	to	stor
usa	osa	us
dzi	dz	di	dziw	dni
▁czas	cza	czes	czar	czak
sh	si	se	ss	sp	st	th
sz	rz	dz	sza	szt	szk	szu	si	oz	se	ez
▁gór	gr	gar
ung	un	ang
▁syna	syn	sona
▁prób	rób
ką	kom	ka	ją	ki	ko	kr
wen	wę	we	en	went
lar	kar	lat	la	ar	klar
graf	grad	gra	gran
ną	na	nią	oną
budowany	budowano
po	op	pi	pp	pon	por	pro
▁świata	świat
czyli	czyni
▁że	ze
ut	ot	tu	it	ur	rut
gin	fin	gon	in
▁rolę	rol
żyt	ryt	cyt	pyt
cu	cy	co	ci
▁roli	rol
ator	stor	tor
▁kab	kan	ka
▁ulega	lega
ica	ca	nica	ice	ina
ret	ter	re	et
tę	ten	te
▁tym	tyn	ty	tom
▁dzieł	dziel	dział	dziej
pa	PA	ps	pan	par
▁firm	form
▁obu	ob	bu
▁szar	sza
ble	bel	be	le
szy	szt	szu	szyn	wszy	szły
ling	lin	lig
▁śpiewa	śpiew
twor	twór	tor
▁grupa	grup
środ	śród	rod
ction	tion
fon	don	gon	fin	on	zon
▁lek	le
rus	rys	ros	us
▁ligi	logi	lig
bot	not	bit	bor	bo	ot
▁ewolucj	ewolucyj
ja	ją	ha	ka	jaw
▁lew	le	ew
▁pisan	pisał
▁gali	gal	gli
et	te	er	ent
ter	ret	te	er	tera	ster
ow	ów	wo	owa	owi	owo	owe	owy	dow
ill	il
▁gości	ości
wę	wen	we	wa
lot	łot	lit	lor	ot
▁sił	sil	si	ił
grad	gard	graf	gra	rad
era	er	tera
tor	tur	rot	to	or	stor
gan	gna	han	an	gran
▁lata	lat
ckie	cie
▁skr	kr	ska	ski
▁grał	gra
▁niemieckie	niemiecki
▁łatw	ław
▁prawo	praw
zm	izm	za	im	om	ze	em
▁US	IS
▁stała	stał
berg	ber	erg	bert	burg
▁akt	tka	at
łow	łów	ław	łot	dow
ania	ana	wania
west	est	wist	went
ris	rus	ros	is	ras	res
val	cal	bal	va	al	vel	van	var	wal
ni	in	bi	mi	nu	no	oni	nie	nic
niki	nicki
źni	ni	oni	dni	śni
szk	szek	sza	sek	szt	szu
▁urząd	rząd
ewski	owski
cję	cę	czę
poli	pol
rop	por	top	ro	op	trop
▁trudn	trud
vo	co	bo	vi	va	no
▁wolny	wolni
ród	rod	ód	gród	śród	rad	red	rów	wód
noszą	nosząc
centr	cent
▁aktywności	aktywność
▁wys	wy	rys
▁kurs	kur
pad	pa	ad	pada
alna	ana
yna	any	na	ana	ina	ona	zna
▁pełny	pełni
▁krzew	krzyw
biegł	bieg
▁lecz	licz
▁nim	min	ni	im	niem
icznych	licznych
esz	es	ez	est
▁piąt	pięt
▁Chr	Ch
ora	or
▁dniem	niem
▁swą	ową
kończył	kończyć
sto	st	to	stor
biór	bór
lut	lot	łot	lit	lu	ut
dów	dow	wód	ów	daw
▁bank	ban
sze	że	se	ze	szer	szew	szek	sza
▁nią	ni	nie
niej	nie	mniej	niem
du	dy	do	ud	di
ard	rad	dra	ar	ad
bud	bus	bu	ud
▁pan	pa	an
ik	ki	ok	il	lik
mer	rem	ner	met	er	metr
▁pełne	pełni
ał	al	wał	dał
▁żona	żon	ona
▁rajd	raj	rad
▁ustaw	staw
▁pie	pi	pe	ie
pie	pi	pe	ie
han	chan	gan	ha	an
dob	sob	don	do	ob
tes	set	res	te	ts	es	est
rem	mer	ren	re	em
cz	czy	cza	czo	cze	czą	czę
kowy	owy	kowa
ście	cie
gor	gór	gro	for	go	gr	or
cząc	czą
ran	nar	tan	rab	ram	an
▁płci	płaci
▁główne	głównie
rze	że	rz	re	ze	prze
gli	li
roż	róż	ro	droż	ros	rop	rot	rok	rod
pul	pol	pół	pl	ul
ową	owa
zel	ze	el	zer
ot	ut	to	it	pt	or	ont	not	rot	pot
▁trwa	tra
spo	sp	po	społ
▁kości	ości
um	om	mu	im	un
cach	ach
fik	fil	fi	fin
mian	min	man
wan	wa	an	wany
anem	nem
▁br	be	bar	bor	ber	bry	bur	bór
sty	st	ty	isty	styk
▁wolno	wolni
▁miejsce	miejsc
ner	ren	ber	mer	ne	er
top	pot	rop	to	op	trop
▁więź	więzi	więc
oz	ozy	ez
ric	tic	nic
skim	ski
▁tys	rys	ty	ts	tyn	typ
czne	cze
ług	log
gat	gar	at
czna	cza	zna	czka
ują	ją	ując	uje
wód	ód	wad	wid
szt	st	sza	set	szk	szu
arzy	ary	przy	trzy
les	le	es	las
▁kry	kr
ciu	ci	cie
tyn	ty	tan	ton	ten
czka	czak	cza
ver	cer	ber	er	var	zer	ner	ser	per	ter	ker
stroj	stron
far	dar	gar	fa	fr	ar
ho	hu	go	hi
▁tro	rot	tor	tri	to	ro	trop
▁ob	ub	bo	on	oba
▁herb	her
mi	im	ni	mu	ami
łac	ław
iec	ice	ie	cie
ro	or	to	ero	ros	rop	pro
ował	owa	wał
rys	rus
wali	wal	owali
tr	te	tra	tar	tri	tor	ter	try	str
sji	ski	si
nus	bus	mus	nu	us
owaniem	owanie
▁nr	br	ne	nt	nar	nor	ner	na	ar
przy	prze	trzy
dar	dra	rad	far	dat	da	dr	ar
▁oraz	raz
wy	owy
▁ko	ku	ok	ki	kor	kro
wrócić	wróci	wrócił
▁II	III
jezd	jazd
▁pod	po	od
▁term	ter	tera
▁te	tę	et	re	ten	ter
ryka	tyka	ryk
czu	czy	czo	cz
óz	oz	ez	rz
ley	le	len
kowie	owie
woj	wo
tion	ton	pion
ela	ale	el	la
▁anty	ant	any
gę	gen
bon	bin	bo	on
kor	kur	kro	rok	lor	ko	kr	or
kowski	owski	nowski
▁łączn	łącz
▁al	la	ale	wal	cal	pal
▁por	pro	rop	pot	po	or
ność	ość
czyć	czy	czyn
grał	gra
sja	ska	ja	sza
niem	nie	nem	iem
ustr	ust	str
▁si	is	di
▁ga	ag	fa	ha	gan	gna	gar	gra
ne	en	be	nie	one	ner
uk	ok	ku	ul
▁prowadził	prowadzić
ii	ie	in	ni
ewskiego	owskiego
▁błon	bon
rut	ryt	rot	tur	ut	rzut
un	on	nu	in	ub
▁ukazał	kazał
▁końcu	kończ
szek	szk	sek	szer
anie	nie	wanie
▁ang	gna	an	ag
ję	je	ja	wę
est	set	es	et	st	west
▁kod	ko	od
ice	cie	ie	ce	nice
▁dziad	dział
▁owoc	owo
▁pat	par	pa	pt	at	part
▁ląd	lad	ład	lud
▁Op	OP
▁kan	ka	an
spól	społ
ach	cach
ve	ce	be	ver	vel	va	vi
▁tele	tel	tle
żu	że	nu
słow	łow	sław
▁ONZ	ON
▁he	je	hr	hen	her
ształ	stał	kształt
▁scen	sen	cen
wania	owania
on	ON	un	no	in	ob	om	ona	oni	ono
form	morf	for
stra	star	str	tra
end	ens	en	den	and	ind	ent	und
tyki	tyk	styki
pp	op	po	pa	pi	pe
AR	AT
ąż	aż
▁czyli	czyni
tic	nic
czo	cz	co	cza	cze	czy
▁port	por	pot
leni	len	letni
ska	ka
ult	ul	ut
▁udział	dział
ell	el
mann	man	mana
nek	ne
▁krwi	kwi
▁cel	vel	ce	el	ciel
cin	nic	vin	con	ci	in	cie	cen	zin
ane	an	ne	anie	anem	ana	ano	one
▁XIII	III
czy	cz	cy	czyn	cza
jawia	mawia
czak	czka	cza	czek	czar
syn	dyn	szyn	sygn	san	son	sen
icznym	niczym
▁itp	it	ita
pen	pe	en
▁wiersz	wierz
ark	rak	kra	ar
com	cą	moc	con	co	om
▁techniczny	techniczne
▁reg	erg	re	ren
town	ton
feld	field
ps	sp	os	pa	pis
▁czyn	czy	czyni	szyn
śród	środ	ród	gród
ess	es	ss	ens
ger	fer	her	gr	er	gier
▁SS	AS
▁sp	ps
th	ta	to	te	ty	ts
alnie	anie
rol	lor	rok	ro
TA	AT
▁się	si
kończyć	kończył
▁być	by	byt
ens	end	en	es	sen	ans
▁form	morf	for
rost	ros	rot
szki	szk	ski
▁prowadzą	prowadza
usza	sza
tyczna	tyczną	tyczne	tyczny
lo	lu	ko	li	lor	lot	lok
rab	bar	ran	rabi
ety	et	ty
▁pełno	pełni
▁miarę	miar
ści	ci	ości	śni
ystów	istów
▁ma	na
mir	mor	mit	mi	miar
▁ple	pel	ole	pl	pe	le
▁kanał	kazał
▁Ar	AR
▁tu	ty	to	ut	atu
ale	al	le
il	ił	li	ul	sil
▁fe	de	fr	fer
▁kup	kop	ku	up
▁ps	sp	os	pa	pis
gn	gna	gan	gin	gon	gen	an	in	go
▁min	mon	mi	in	mian
nów	ów	rów	ców
▁lat	tal	lar	la	at
▁łuk	lok
▁cud	ud
lew	le	ew
tt	ty	ta	at	it	to	ot
szyn	syn	czyn
ion	in	on	pion	tion	oni
▁KM	AM
ść	ość
waż	wa	aż	wan	war	wyż
▁sz	rz	dz	sza	szt	szk	szu	si	oz	se	ez
▁dy	yd	du	dyn
▁Is	IS
qui	qua	que
▁mar	ram	nar	mat	ma	ar	miar
kowych	owych
▁niemiecka	niemiecki
awski	owski
powiedzi	powiedź
▁długi	długo
tów	rów	ów	tzw	nów	ców	łów
ri	ro	ari	tri	ii
tz	rz	tzw	ta	to	oz	te	ez	cz
▁list	lit
boj	bój	bo
ine	nie	one	in	ie	ne
czar	cza	car
▁który	którzy
ald	lad	al	ad	dal	ale	and
▁dnia	dni
dent	den	ent	went	cent
▁strat	stat
cjon	con	jon
ele	el	le
tą	tom	ton	ta
ijn	in
wierc	wierz
icznego	niczego
vel	cel	bel	el	ver	pel	tel	mel
del	de	el	dal
jew	je	ew	jaw
▁były	był
gni	gin	ni
pier	pie	per	pierw
nar	ran	bar	mar	na	ar	nor	ner
tar	tra	rat	ta	ar	star
▁miejscu	miejsc
▁dzień	dziel	dziej
bił	bil	bi	ił
niesienia	niesienie
try	ty	trzy	tury
up	op
sił	sil	si	ił
▁swych	owych	szych
▁opart	part
